15
111111111111111
100000000000001
100000000000001
100200000110001
100000001001001
100000010010001
100000100100001
100000010010001
100000001001001
100000000110001
101001000000001
101001111110001
101011000010001
100000000010001
111111111111111
