20
11111111111111111111
10001010000001000001
10001010000001000001
10001010002001000001
10001010000001111101
10001010000000000101
10001011111111100101
10001000000000100101
10001110000000100101
10000010000000100101
11100010000000100101
10100010111111100101
10100010100000001101
10100010100000011001
10100010100000010001
10100010111000110001
10100011111000100001
10100000000000100001
10111111111111100001
11111111111111111111
