8
1111111
1020001
1000001
1011001
1011001
1000001
1111111
