1111111111
0000000000
0000000000
0000000000
00000F0000
0000000000
00000P0000
0000000
0000
1